107 100 100 100 100 100 100 100 100 133 100 100 100 100 100 100 100 100 108 
101 0 0 0 0 0 0 0 0 101 0 0 0 0 0 0 0 0 101 
101 0 107 108 0 107 133 108 0 101 0 107 133 108 0 107 108 0 101 
101 0 105 106 0 105 130 106 0 110 0 105 130 106 0 105 106 0 101 
101 0 0 0 0 0 0 0 0 0 0 0 0 0 0 0 0 0 101 
101 0 111 112 0 113 0 111 100 133 100 112 0 113 0 111 112 0 101 
101 0 0 0 0 101 0 0 0 101 0 0 0 101 0 0 0 0 101 
105 100 100 108 0 131 100 112 0 110 0 111 100 132 0 107 100 100 106 
0 0 0 101 0 101 0 0 0 0 0 0 0 101 0 101 0 0 0 
111 100 100 106 0 110 0 107 112 1 111 108 0 110 0 105 100 100 112 
20 0 0 0 0 0 0 101 0 0 0 101 0 0 0 0 0 0 20 
111 100 100 108 0 113 0 105 100 100 100 106 0 113 0 107 100 100 112 
0 0 0 101 0 101 0 0 0 0 0 0 0 101 0 101 0 0 0 
107 100 100 106 0 110 0 111 100 133 100 112 0 110 0 105 100 100 108 
101 0 0 0 0 0 0 0 0 101 0 0 0 0 0 0 0 0 101 
101 0 111 108 0 111 100 112 0 110 0 111 100 112 0 107 112 0 101 
101 0 0 101 0 0 0 0 0 0 0 0 0 0 0 101 0 0 101 
131 112 0 110 0 113 0 111 100 133 100 112 0 113 0 110 0 111 132 
101 0 0 0 0 101 0 0 0 101 0 0 0 101 0 0 0 0 101 
101 0 111 100 100 130 100 112 0 110 0 111 100 130 100 100 112 0 101 
101 0 0 0 0 0 0 0 0 0 0 0 0 0 0 0 0 0 101 
105 100 100 100 100 100 100 100 100 100 100 100 100 100 100 100 100 100 106 
0 0 0 0 0 0 0 0 0 0 0 0 0 0 0 0 0 0 0 