107 100 100 100 100 100 100 100 100 133 100 100 100 100 100 100 100 100 108 
101 2 2 2 2 2 2 2 2 101 2 2 2 2 2 2 2 2 101 
101 3 107 108 2 107 133 108 2 101 2 107 133 108 2 107 108 3 101 
101 2 105 106 2 105 130 106 2 110 2 105 130 106 2 105 106 2 101 
101 2 2 2 2 2 2 2 2 2 2 2 2 2 2 2 2 2 101 
101 2 111 112 2 113 2 111 100 133 100 112 2 113 2 111 112 2 101 
101 2 2 2 2 101 2 2 2 101 2 2 2 101 2 2 2 2 101 
105 100 100 108 2 131 100 112 0 110 0 111 100 132 2 107 100 100 106 
0 0 0 101 2 101 0 0 0 0 0 0 0 101 2 101 0 0 0 
111 100 100 106 2 110 0 107 112 1 111 108 0 110 2 105 100 100 112 
20 0 0 0 2 0 0 101 0 0 0 101 0 0 2 0 0 0 20 
111 100 100 108 2 113 0 105 100 100 100 106 0 113 2 107 100 100 112 
0 0 0 101 2 101 0 0 0 0 0 0 0 101 2 101 0 0 0 
107 100 100 106 2 110 0 111 100 133 100 112 0 110 2 105 100 100 108 
101 2 2 2 2 2 2 2 2 101 2 2 2 2 2 2 2 2 101 
101 2 111 108 2 111 100 112 2 110 2 111 100 112 2 107 112 2 101 
101 3 2 101 2 2 2 2 2 2 2 2 2 2 2 101 2 3 101 
131 112 2 110 2 113 2 111 100 133 100 112 2 113 2 110 2 111 132 
101 2 2 2 2 101 2 2 2 101 2 2 2 101 2 2 2 2 101 
101 2 111 100 100 130 100 112 2 110 2 111 100 130 100 100 112 2 101 
101 2 2 2 2 2 2 2 2 2 2 2 2 2 2 2 2 2 101 
105 100 100 100 100 100 100 100 100 100 100 100 100 100 100 100 100 100 106 
0 0 0 0 0 0 0 0 0 0 0 0 0 0 0 0 0 0 0 